451 452 452 452 452 454 451 452 452 452 452 452 452 452 452 452 452 452 452 452 452 454 451 452 452 452 452 452 452 452 452 452 452 452 452 452 452 452 452 454 
505 111 111 111 111 508 505 111 111 111 111 111 111 111 111 111 111 111 111 111 111 508 505 111 111 111 111 111 111 111 111 111 111 111 111 111 111 111 111 508 
505 111 451 111 111 508 505 111 111 111 111 111 111 111 451 454 451 454 111 111 111 508 505 111 111 111 111 111 111 111 111 111 111 111 111 111 111 111 111 508 
505 111 111 616 111 111 111 111 111 111 111 111 111 111 613 616 613 616 111 111 111 508 505 111 111 111 111 111 111 111 508 505 111 111 111 111 111 111 111 508 
505 111 111 111 111 111 111 111 111 111 111 111 111 111 111 111 111 111 111 111 111 508 505 111 111 111 111 111 111 111 508 505 111 111 111 111 111 111 111 508 
613 614 614 614 614 614 614 614 614 614 614 1045 111 111 111 111 111 111 111 111 111 508 505 111 111 111 111 111 111 111 508 505 111 111 111 111 111 111 111 508 
451 452 452 452 452 452 452 452 452 452 454 505 111 111 111 111 111 111 111 111 111 508 505 111 451 613 454 616 111 111 508 505 111 111 451 613 454 616 111 508 
505 111 111 111 111 111 111 111 111 111 508 505 111 111 111 111 111 111 111 111 111 508 505 111 111 111 111 111 111 111 508 505 111 111 111 111 111 111 111 508 
505 111 111 111 111 451 452 452 454 111 508 505 111 111 111 451 454 111 111 111 111 508 505 111 111 111 111 111 111 111 508 505 111 111 111 111 111 111 111 508 
505 111 111 111 111 111 111 111 111 111 508 505 111 111 111 613 616 111 111 111 111 508 505 111 111 614 614 614 614 614 616 613 614 614 614 614 614 111 111 508 
505 111 111 111 111 111 111 111 111 111 508 505 111 111 111 111 111 111 111 111 111 508 505 111 111 452 452 452 452 452 452 452 452 452 452 452 452 111 111 508 
505 111 111 111 111 111 111 111 111 111 508 505 111 111 111 111 111 111 111 111 111 508 505 111 111 111 111 111 111 111 111 111 111 111 111 111 111 111 111 508 
505 111 613 614 614 616 111 111 111 111 111 111 111 111 111 111 111 111 111 111 111 508 505 111 111 111 111 111 111 111 111 111 111 111 111 111 111 111 111 508 
505 111 111 111 111 111 111 111 111 111 111 111 111 111 111 508 505 111 111 111 111 508 505 111 111 111 451 616 613 454 616 451 613 454 616 111 111 111 111 508 
613 614 614 614 614 614 614 614 614 614 614 111 111 111 111 508 505 111 111 111 111 508 505 111 111 111 111 111 111 111 111 111 111 111 111 111 111 111 111 508 
451 452 452 452 452 452 452 452 452 452 452 111 111 111 111 508 505 111 111 111 111 508 505 111 111 111 111 111 111 111 111 111 111 111 111 111 111 111 111 508 
505 111 111 111 111 111 111 111 111 111 111 111 111 111 111 508 505 111 111 111 111 508 613 614 614 614 614 614 614 614 614 614 614 614 111 111 111 111 614 616 
505 111 111 111 111 111 111 111 111 111 111 111 111 111 111 508 505 111 111 111 111 886 452 452 452 452 452 452 452 452 452 452 452 452 111 111 111 111 452 454 
505 111 111 111 111 508 505 111 111 111 451 454 111 111 111 508 505 111 111 111 111 111 111 111 111 111 111 111 111 111 111 111 111 111 111 111 111 111 111 508 
505 111 111 111 111 508 505 111 111 111 613 616 111 111 111 508 505 111 111 111 111 111 451 613 454 616 451 613 454 616 111 111 111 111 451 613 454 616 111 508 
505 111 111 111 111 508 505 111 111 111 111 111 111 111 111 508 505 111 111 111 111 111 111 111 111 111 111 111 111 111 111 111 111 111 111 111 111 111 111 508 
613 614 614 614 614 616 613 614 614 614 614 614 614 614 614 616 613 614 614 614 614 614 614 614 614 614 614 614 614 614 614 614 614 614 614 614 614 614 614 616