451 452 452 452 452 452 452 452 452 452 452 452 452 452 452 452 452 452 452 452 452 452 452 452 452 452 452 452 452 452 452 454 
505 169 169 169 169 169 169 169 169 169 169 169 169 169 169 169 169 169 169 169 169 169 169 169 169 169 169 169 169 169 169 508 
505 169 169 169 169 169 169 169 169 169 169 169 169 505 169 169 169 169 169 169 169 169 169 169 169 169 169 169 169 169 169 508 
505 169 169 169 169 169 169 169 169 169 169 169 169 505 169 169 169 169 169 169 169 169 169 169 169 169 169 169 169 169 169 508 
505 169 169 169 169 169 169 169 169 169 169 169 169 505 169 169 169 169 169 169 169 169 169 169 169 169 169 169 169 505 169 508 
505 169 169 505 169 169 169 169 169 169 169 169 169 505 169 169 505 169 169 169 169 169 169 169 169 169 169 169 169 505 169 508 
505 169 169 505 169 169 169 169 169 169 169 169 169 505 169 169 505 169 169 169 169 169 169 169 169 169 169 169 169 505 169 508 
505 169 169 505 169 169 169 169 169 169 169 169 169 505 169 169 505 169 169 169 169 169 169 169 169 169 169 169 169 505 169 508 
505 169 169 505 169 169 169 169 169 169 169 169 169 505 169 169 505 169 169 169 169 169 169 169 169 169 169 169 169 505 169 508 
505 169 169 505 169 169 169 169 169 169 169 169 169 505 169 169 505 169 169 169 614 614 614 614 614 614 614 614 169 505 169 508 
505 169 169 505 169 169 169 169 169 505 169 169 169 505 169 169 505 169 169 169 169 169 169 169 169 169 169 169 169 505 169 508 
505 169 169 505 169 169 169 169 169 505 169 169 169 505 169 169 505 169 169 169 169 169 169 169 169 169 169 169 169 505 169 508 
505 169 169 505 169 169 169 169 169 505 169 169 169 505 169 169 505 169 169 169 505 169 169 169 169 169 169 169 169 505 169 508 
505 169 169 505 169 169 169 169 169 505 169 169 169 505 169 169 505 169 169 169 505 169 169 169 169 169 169 169 169 169 169 508 
505 169 169 505 169 169 169 169 169 505 169 169 169 505 169 169 505 169 169 169 505 169 169 169 169 169 169 169 169 169 169 508 
505 169 169 169 169 169 169 169 169 505 169 169 169 169 169 169 505 169 169 169 505 169 169 169 169 169 169 169 169 169 169 508 
505 169 169 169 169 169 169 169 169 505 169 169 169 169 169 169 505 169 169 169 505 169 169 169 169 169 169 169 169 169 169 508 
505 169 169 169 169 169 169 169 169 505 169 169 452 452 169 169 505 169 169 169 505 169 169 169 169 169 169 169 169 169 169 508 
505 169 169 169 169 169 169 169 169 505 169 169 169 169 169 169 505 169 169 169 505 169 169 169 169 169 169 169 169 169 169 508 
505 169 169 169 169 169 169 169 169 169 169 169 169 169 169 169 169 169 169 169 169 169 169 169 169 169 169 169 169 169 169 508 
505 169 169 169 169 169 169 169 169 169 169 169 169 169 169 169 169 169 169 169 169 169 169 169 169 169 169 169 169 169 169 508 
613 614 614 614 614 614 614 614 614 614 614 614 614 614 614 614 614 614 614 614 614 614 614 614 614 614 614 614 614 614 614 616

