63 63 63 63 63 63 63 63 63 63 63 63 63 63 63 63 63 63 63 63 63 63 63 63 63 63 435 63 63 63 63 63 63 63 63 63 63 63 63 435 435 63 63 63 63 63 63 63 63 63 435 435 435 435 435 435 435 435 435 435 435 435 435 435 435 435 435 435 435 435 435 435 435 435 435 435 435 435 435 435 435 435 435 435 435 435 435 435 435 435 435 435 435 435 435 435 435 435 435 435 435 435 435 435 435 435 435 435 435 435 435 435 435 435 435 435 435 435 435 435 435 435 435 435 435 435 435 435 435 435 435 435 435 435 435 435 435 435 435 435 435 435 435 435 435 435 435 435 435 436 
63 63 63 63 111 111 111 63 63 111 111 111 63 63 63 111 111 111 111 63 63 63 63 63 63 63 63 63 63 63 63 63 63 63 63 111 111 111 111 111 63 111 111 111 63 63 63 63 63 63 63 63 63 63 111 111 111 111 111 111 111 111 111 111 111 111 111 111 111 111 111 111 111 111 111 111 111 111 111 111 111 111 111 111 111 111 111 111 111 111 111 111 111 111 111 111 111 111 111 111 111 111 111 111 111 111 111 111 111 111 435 435 435 435 111 111 111 111 111 435 435 435 435 435 111 111 111 111 111 111 111 111 111 111 111 111 111 111 111 111 111 111 111 111 111 111 111 111 111 490 
63 63 111 111 111 111 111 111 111 111 111 111 111 111 111 111 111 111 111 111 111 111 111 111 111 111 63 63 63 111 111 111 111 111 111 111 111 111 111 111 111 111 111 111 111 111 63 63 63 63 63 111 111 111 111 111 111 111 111 111 111 111 111 111 111 111 111 111 111 111 111 111 111 111 111 111 111 111 111 111 111 111 111 111 111 111 111 111 111 111 111 111 111 111 111 111 111 111 111 111 111 111 111 111 111 111 111 111 111 111 111 111 111 111 111 111 111 111 111 111 111 111 111 111 111 111 111 111 111 111 111 111 111 111 111 111 111 111 111 111 111 111 111 111 111 111 111 111 111 490 
63 63 63 111 111 111 111 111 111 111 111 111 111 111 111 111 111 111 111 111 111 111 111 111 111 111 111 111 111 111 111 111 111 111 111 111 111 111 111 111 111 111 67 111 111 111 63 63 63 63 111 111 111 111 111 111 111 111 111 111 111 111 111 111 111 111 111 111 111 111 111 111 111 111 111 111 111 111 111 111 63 63 63 111 111 111 111 111 111 111 111 111 111 63 63 63 63 63 63 63 111 111 111 111 111 111 111 111 111 111 111 111 111 111 111 111 111 111 111 111 111 111 111 111 111 111 111 111 111 111 111 111 111 111 111 111 111 111 111 111 111 111 111 907 908 111 111 111 111 490 
63 63 111 111 111 111 111 111 111 111 111 111 111 111 111 111 111 111 111 111 111 111 111 111 111 111 111 111 111 111 111 111 111 111 111 111 111 67 67 67 111 67 67 63 63 63 63 63 63 63 111 111 111 111 111 111 111 111 111 111 111 111 111 111 111 111 111 111 111 111 111 111 63 63 63 63 63 63 63 63 111 111 111 63 63 63 63 63 63 63 63 63 63 165 165 165 165 165 63 63 111 111 111 111 111 111 111 111 111 111 111 111 111 111 111 111 111 111 111 111 111 111 111 111 111 111 111 111 111 111 111 111 111 111 111 111 111 111 111 111 111 111 111 961 962 111 111 111 111 490 
63 63 111 111 111 111 111 111 111 165 165 111 111 111 111 111 111 111 111 111 111 111 111 111 111 111 111 111 111 111 111 111 111 111 111 111 67 67 223 67 67 63 63 63 63 63 63 63 63 111 111 111 111 111 111 111 111 111 111 111 111 111 111 111 111 111 111 111 111 111 111 63 63 111 111 111 111 111 111 111 111 111 111 111 111 111 111 111 111 111 63 63 63 63 63 165 63 63 63 111 111 111 111 111 111 111 111 111 111 111 111 111 111 111 111 111 111 111 111 111 111 111 111 111 111 111 111 111 111 111 111 111 111 111 111 111 111 111 111 111 111 111 111 111 111 111 111 111 111 490 
63 63 111 111 111 111 111 111 111 165 165 165 111 111 111 111 165 165 165 165 165 165 165 111 111 111 111 111 111 111 111 111 111 111 67 67 67 67 67 67 67 63 63 63 63 63 111 111 111 111 111 111 111 111 111 111 111 111 111 111 111 111 111 111 111 111 111 111 111 111 111 111 63 63 63 63 63 111 111 111 111 111 111 111 111 63 63 63 63 63 63 63 63 63 63 63 111 111 111 111 111 111 111 111 111 111 111 111 111 111 111 111 111 111 111 111 111 111 111 111 111 111 111 111 111 111 111 111 111 111 111 111 111 111 111 111 111 111 111 111 111 111 111 111 111 111 111 111 111 490 
63 63 111 111 111 907 908 111 111 223 165 165 165 165 165 165 165 165 165 165 165 165 111 111 111 111 111 111 165 165 165 67 67 67 67 67 67 67 67 63 63 63 63 111 111 111 111 111 111 111 111 111 111 111 111 111 111 111 111 111 111 111 111 111 111 111 111 111 111 111 111 111 111 111 63 63 63 63 111 111 111 111 63 63 63 63 63 111 111 111 111 111 111 111 111 111 111 111 111 111 111 111 111 111 111 111 111 111 111 111 111 111 111 111 111 111 111 111 111 111 111 111 111 111 111 111 111 111 111 111 111 111 111 111 111 111 111 111 111 111 111 111 111 111 111 111 111 111 111 490 
487 63 111 111 111 961 962 111 111 223 165 165 165 165 165 165 165 165 165 165 111 111 111 111 165 165 165 165 67 67 67 67 67 67 165 165 63 63 63 63 111 111 111 111 111 111 111 111 111 111 111 111 111 111 111 111 111 111 111 111 111 111 111 111 111 111 111 111 111 111 111 111 111 111 111 111 63 63 63 63 111 111 111 111 111 111 111 111 111 111 111 111 111 111 111 111 111 111 111 111 111 111 111 111 111 111 111 111 111 111 111 111 111 111 111 111 111 111 111 111 111 111 111 111 111 111 111 111 111 111 111 111 111 111 111 111 111 111 111 111 111 111 111 111 111 111 111 111 111 490 
487 63 111 111 111 111 111 111 111 111 223 165 165 165 165 165 165 165 165 165 165 165 165 165 165 67 67 67 67 67 67 67 63 63 63 63 111 111 111 111 111 111 111 111 111 111 111 111 111 111 111 111 111 111 111 111 111 111 111 111 111 111 111 111 111 111 111 111 111 111 111 111 111 111 111 111 111 111 63 63 111 111 111 111 111 111 111 111 111 111 111 111 111 111 111 111 111 111 111 111 111 111 111 111 111 111 111 111 111 111 111 111 111 111 111 111 111 111 111 111 111 111 111 111 111 111 111 111 111 111 111 111 111 111 111 111 111 111 111 111 111 111 111 111 111 111 111 111 111 490 
487 63 111 111 111 111 111 111 111 111 223 165 165 165 165 165 165 165 165 165 165 67 67 67 67 67 63 63 63 63 63 63 111 111 111 111 111 111 111 111 111 111 111 111 111 111 111 111 111 111 111 111 111 111 111 111 111 111 111 111 111 111 111 111 111 111 111 111 111 111 111 111 111 111 111 111 111 111 111 63 111 111 111 111 111 111 111 111 111 111 111 111 111 111 111 111 111 111 111 111 111 111 111 111 111 111 111 111 111 111 111 111 111 111 111 111 111 111 111 111 111 111 111 111 111 111 111 111 111 111 111 111 111 111 111 111 111 111 111 111 111 111 111 111 111 111 111 111 111 490 
487 63 111 111 111 111 111 111 111 111 111 111 165 165 165 165 165 165 165 63 63 63 63 63 63 111 111 111 111 111 111 111 111 111 111 111 111 111 111 111 111 111 111 111 111 111 111 111 111 111 111 111 111 111 111 111 111 111 111 111 111 111 111 111 111 111 111 111 111 111 111 111 111 111 111 111 111 111 111 111 111 111 111 111 111 111 111 111 111 111 111 111 111 111 111 111 111 111 111 111 111 111 111 111 111 111 111 111 111 111 111 111 111 111 111 111 111 111 111 111 111 111 111 111 111 111 111 111 111 111 111 111 111 111 111 111 111 111 111 111 111 111 111 111 111 111 111 111 111 490 
487 63 111 111 111 111 111 111 111 111 111 111 111 165 165 63 63 63 63 63 63 63 111 111 111 111 111 111 111 111 111 111 111 111 111 111 111 111 111 111 111 111 111 111 111 111 111 111 111 111 111 111 111 111 111 111 111 111 111 111 111 63 63 63 63 63 63 111 111 111 111 111 111 111 111 111 111 111 111 111 111 111 111 111 111 111 111 111 111 111 111 111 111 111 111 111 111 111 111 111 168 168 168 111 111 111 111 111 111 111 111 111 111 111 111 111 111 63 111 111 111 111 111 111 111 111 111 111 111 111 111 111 111 111 111 111 111 111 111 111 111 111 111 111 111 111 111 111 111 490 
487 63 111 111 111 111 111 111 111 111 111 111 111 111 111 111 63 63 63 111 111 111 111 111 111 111 111 111 111 111 111 111 111 111 111 111 111 111 111 111 111 111 111 111 111 111 111 111 111 111 111 111 111 111 111 111 111 63 63 63 63 63 63 63 63 165 165 63 63 111 111 111 111 111 111 63 111 111 111 111 111 111 111 111 111 111 63 63 63 63 63 63 63 63 63 63 63 168 168 168 168 168 168 168 63 63 63 63 63 63 63 63 63 63 111 111 111 63 111 111 63 111 111 111 111 111 111 111 111 111 111 111 111 111 111 111 111 111 111 111 111 111 111 111 63 63 63 63 63 490 
487 63 111 111 111 111 111 111 111 111 111 111 111 111 111 111 111 111 111 111 111 111 111 111 111 111 111 111 111 111 111 111 111 111 111 111 111 111 111 111 111 111 111 111 111 111 111 111 111 111 111 111 111 111 111 63 63 63 63 63 111 111 111 111 63 63 63 63 63 63 63 63 111 111 63 63 63 63 63 63 63 63 63 63 63 63 63 63 63 63 63 63 63 63 63 63 63 168 168 168 168 168 168 168 63 63 63 63 63 63 63 63 63 63 63 63 63 63 63 63 63 111 111 111 111 111 111 111 111 111 111 111 111 111 111 111 111 111 63 63 63 63 63 63 63 63 63 63 63 63 
487 63 111 111 111 111 111 111 111 111 111 111 63 111 111 111 111 111 111 111 111 111 111 111 111 111 111 111 111 111 111 111 111 111 111 111 111 111 111 111 111 111 111 111 111 111 111 111 111 111 111 111 63 63 63 63 63 111 111 111 111 907 908 111 63 63 63 63 63 63 63 111 111 111 63 63 63 63 63 63 63 63 63 63 63 63 111 111 111 111 111 111 111 111 111 111 111 111 111 111 111 168 168 111 111 111 111 111 111 111 111 111 111 111 111 111 111 63 63 63 63 63 63 111 111 63 63 111 111 111 111 111 111 111 111 111 111 63 63 63 63 63 63 63 63 63 111 111 111 490 
487 63 111 111 111 111 111 111 111 111 111 111 111 111 111 111 111 111 111 111 111 111 111 111 111 111 111 111 111 111 111 111 111 111 111 111 111 111 111 111 111 111 111 111 111 111 111 111 111 111 63 63 63 63 63 111 111 111 111 111 111 961 962 63 63 63 63 63 111 111 111 111 111 111 63 63 63 111 111 111 111 111 111 111 111 111 111 111 111 111 111 111 111 111 111 111 111 111 111 111 111 111 111 111 111 111 111 111 111 111 111 111 111 111 111 111 111 63 165 165 63 111 111 63 63 63 63 111 111 111 111 111 111 111 111 111 111 63 63 111 111 111 63 111 111 111 111 111 111 490 
487 63 111 111 63 223 63 111 111 111 111 111 111 111 111 111 111 111 111 111 111 111 111 111 111 111 111 111 111 111 111 111 111 111 111 111 111 111 111 111 111 111 111 111 111 111 111 111 63 63 63 63 63 111 111 111 111 111 111 111 111 111 111 63 111 111 63 111 111 111 111 111 111 111 63 63 63 63 111 111 111 111 111 111 111 111 111 111 111 111 111 111 111 111 111 111 111 111 111 111 111 111 111 111 111 111 111 111 111 111 111 111 111 111 111 111 111 63 63 165 63 111 111 111 111 111 111 111 111 111 111 111 111 111 111 111 63 63 63 111 111 111 111 111 111 111 111 111 111 490 
63 63 63 63 223 165 111 111 111 111 111 111 111 111 111 111 111 111 111 111 111 111 111 111 111 111 111 111 111 111 111 111 111 111 111 111 111 111 111 111 111 111 111 111 111 63 63 63 63 63 63 111 111 111 111 111 111 111 111 111 111 111 111 111 111 111 63 111 111 111 111 111 111 111 111 111 63 63 111 111 111 111 111 111 111 111 111 111 111 111 111 111 111 111 111 111 111 111 111 111 111 111 111 111 111 111 111 111 111 111 111 111 111 111 111 111 111 63 63 165 63 111 111 111 111 111 111 111 111 111 111 111 111 111 111 111 63 63 63 111 111 111 111 111 111 111 111 111 111 490 
487 111 111 111 223 223 111 111 111 111 111 111 111 111 111 111 111 111 111 111 111 111 111 111 111 111 111 111 111 111 111 111 111 111 111 111 111 111 111 111 111 111 111 63 63 165 63 63 63 111 111 111 111 111 111 111 111 111 111 111 111 111 111 111 111 111 63 111 111 111 111 111 111 111 111 111 63 63 111 111 111 111 111 111 111 111 111 111 111 111 111 111 111 111 111 111 111 111 111 111 111 111 111 111 111 111 111 111 111 111 111 111 111 111 111 111 111 111 63 63 63 111 111 111 111 111 111 111 111 111 111 111 111 111 111 111 111 63 63 111 111 111 111 111 111 907 908 111 111 490 
487 111 111 111 111 111 111 111 111 111 111 111 111 111 111 111 111 111 111 111 111 111 111 111 111 111 111 111 111 111 111 111 111 111 111 111 111 111 111 111 111 111 111 63 165 63 63 63 63 111 111 111 111 111 111 111 111 111 111 111 111 111 111 111 111 111 63 111 111 111 111 111 111 111 111 111 63 63 111 111 111 111 111 111 111 111 111 111 111 111 111 111 111 111 111 111 111 111 111 111 111 111 111 111 111 111 111 111 111 111 111 111 111 111 111 111 111 111 63 63 63 111 111 111 111 111 111 111 111 111 111 111 111 111 111 111 111 63 63 111 111 111 111 111 111 961 962 111 111 490 
487 111 111 111 111 111 111 111 111 111 111 111 111 111 111 111 111 111 111 111 111 111 111 111 111 111 111 111 111 111 111 111 111 111 111 111 111 111 111 111 111 111 111 111 63 63 63 63 111 111 111 111 111 111 111 111 111 111 111 111 111 111 111 111 111 111 63 111 111 111 111 111 111 111 111 111 111 63 111 111 111 111 111 111 111 111 111 111 111 111 111 111 111 111 111 61 61 61 61 61 111 111 111 111 111 111 111 111 111 111 111 111 111 111 111 111 111 111 63 63 63 111 111 111 111 111 111 111 111 111 111 111 111 111 111 111 111 111 63 111 111 111 111 111 111 111 111 111 111 490 
487 111 111 111 111 111 111 111 111 111 111 111 111 111 111 111 111 111 111 111 111 111 111 111 111 111 111 111 111 111 111 111 111 111 111 111 111 111 111 111 111 111 168 63 63 63 63 111 111 111 111 111 111 111 111 111 111 111 111 111 111 111 111 111 111 111 63 111 111 111 111 111 111 111 111 111 63 63 111 111 111 111 111 111 111 111 111 111 111 111 111 111 111 111 61 61 67 67 67 67 111 111 111 111 111 111 111 111 111 111 111 111 111 111 111 111 111 111 63 165 63 111 111 111 111 111 111 111 111 111 111 111 111 111 111 111 111 111 63 111 111 111 111 111 111 111 111 111 111 490 
487 111 111 111 111 111 111 111 111 111 111 111 111 111 111 111 111 111 111 111 111 111 111 111 63 63 63 63 63 63 63 111 111 111 111 111 111 111 111 111 111 168 168 63 63 63 111 111 111 111 111 111 111 111 111 111 111 111 111 111 111 111 111 111 111 111 63 111 111 111 111 111 111 111 111 111 63 63 63 111 111 111 111 111 111 111 111 111 111 111 111 111 111 111 61 61 61 67 67 61 61 61 111 111 111 111 111 111 111 111 111 111 111 111 111 111 111 111 63 165 63 111 111 111 111 111 111 111 111 111 111 111 111 111 111 111 111 111 63 63 111 111 111 111 111 111 111 111 111 490 
487 111 111 111 111 111 111 111 111 111 111 111 111 111 111 111 111 111 111 111 63 63 63 63 63 63 63 63 63 63 63 63 111 111 111 168 168 111 111 111 168 168 168 63 63 111 111 111 111 111 111 111 111 111 111 111 111 111 111 111 111 111 111 111 111 111 63 111 111 111 111 111 111 111 111 111 63 63 63 111 111 111 111 111 111 111 111 111 111 111 111 111 111 111 61 61 61 61 61 61 61 61 111 111 111 111 111 111 111 111 111 111 111 111 111 111 111 111 63 63 63 111 111 111 111 111 111 111 111 111 111 111 111 111 111 111 111 111 222 222 111 111 111 111 111 111 111 111 111 490 
487 111 111 111 111 111 111 111 111 111 111 111 111 111 111 111 111 63 63 63 67 67 67 111 111 111 111 111 111 111 111 63 63 63 168 168 168 168 168 168 168 168 168 63 111 111 111 111 111 111 111 111 111 111 111 111 111 111 111 111 111 111 111 111 111 111 111 63 111 111 111 111 111 111 111 111 63 63 63 111 111 111 111 111 111 111 111 111 111 111 111 111 111 111 111 111 111 111 111 111 111 111 111 111 111 111 111 111 111 111 111 111 111 111 111 111 111 111 63 63 111 111 111 111 111 111 111 111 111 111 111 111 111 111 111 111 111 222 222 222 111 111 111 111 111 111 111 111 111 490 
487 111 111 111 111 111 111 111 111 111 111 111 111 111 111 111 63 63 63 67 67 67 67 111 111 111 111 111 111 111 111 111 111 111 63 168 168 168 168 168 168 168 168 111 111 111 111 111 111 111 111 111 111 111 111 111 111 111 111 111 111 111 111 111 111 111 111 63 111 111 111 111 111 111 111 111 111 63 63 111 111 111 67 111 111 111 111 111 111 111 111 111 111 111 111 111 907 908 111 907 908 111 111 111 111 111 111 111 111 111 111 111 111 111 111 111 111 111 63 63 111 111 111 111 111 111 111 111 111 111 111 111 111 111 111 111 111 222 222 222 111 111 111 111 111 111 111 111 111 490 
487 111 111 111 111 111 111 111 111 111 111 111 111 111 111 111 63 67 67 67 67 111 111 111 111 111 111 111 111 111 111 111 111 111 111 111 168 168 168 168 168 168 111 111 111 111 111 111 111 111 111 111 111 111 111 111 111 111 111 111 111 111 111 111 111 111 111 63 111 111 111 111 111 111 111 111 111 63 63 111 111 111 67 67 111 111 111 111 111 111 111 111 111 111 111 111 961 962 111 961 962 111 111 169 169 169 169 169 111 111 111 111 111 111 111 111 111 111 63 111 111 111 111 111 111 111 111 111 111 111 111 111 111 111 111 111 111 222 222 222 111 111 111 111 111 111 111 111 111 490 
487 111 111 111 111 111 111 111 111 111 111 111 111 111 111 63 67 67 67 111 111 111 111 111 111 111 111 111 111 111 111 111 111 111 111 111 111 111 111 111 111 111 111 111 111 111 111 111 111 111 111 111 111 111 111 111 111 111 111 111 111 111 111 111 111 111 111 63 111 111 111 111 111 111 111 111 111 111 63 111 67 67 67 67 67 67 63 57 57 57 57 57 57 111 111 111 111 111 111 169 169 169 169 169 169 169 169 169 111 111 111 111 111 111 111 111 111 63 63 111 111 111 111 111 111 111 111 111 111 111 111 111 111 111 111 111 222 222 222 222 222 111 111 111 111 111 111 111 278 490 
487 111 111 111 111 111 111 111 111 111 111 111 111 111 63 67 67 111 111 907 908 111 111 111 111 111 111 111 111 111 111 111 111 111 111 111 111 111 111 111 111 111 111 111 111 111 111 111 111 111 111 111 111 111 111 111 111 111 111 111 111 111 111 111 111 111 111 63 111 111 111 111 111 111 111 111 111 111 63 111 67 67 67 67 67 67 57 111 111 111 111 111 57 57 169 169 169 169 169 169 169 169 169 111 111 111 111 111 63 111 111 111 111 111 111 111 63 63 63 111 111 111 111 111 111 111 111 111 111 111 111 111 111 111 111 111 111 111 63 165 63 63 111 111 111 111 111 111 111 544 