487 111 111 111 111 111 111 111 111 111 111 111 111 63 63 67 67 111 111 961 962 111 111 111 111 111 111 111 111 111 111 111 111 111 111 111 111 111 111 111 111 111 111 111 111 111 111 111 111 111 111 111 111 111 111 111 111 111 111 111 111 111 111 111 111 111 111 63 111 111 111 111 111 111 111 111 111 111 63 63 67 67 67 111 111 111 111 111 111 111 111 111 111 57 57 169 111 111 111 111 111 111 111 111 111 111 111 111 111 63 111 111 111 111 63 63 63 63 111 111 111 111 111 111 111 111 111 111 111 111 111 111 111 111 111 111 111 111 63 63 165 63 111 111 111 111 111 111 111 544 
487 111 111 111 111 111 111 111 111 111 111 111 111 63 63 165 67 111 111 111 111 111 111 111 111 111 111 111 111 111 111 111 111 111 111 111 111 111 111 111 111 111 111 111 111 111 111 111 111 111 111 111 111 111 111 111 111 111 111 111 111 111 111 111 111 111 111 63 111 111 111 111 111 111 111 111 111 111 63 63 111 111 111 111 111 111 111 111 111 111 111 111 111 111 111 111 111 111 111 111 111 111 111 111 111 111 111 111 111 111 63 63 63 63 63 63 63 63 111 111 111 111 111 111 111 111 111 111 111 111 111 111 111 111 111 111 111 111 111 63 165 63 111 111 111 111 111 111 111 544 
487 111 111 111 111 111 111 111 111 111 111 111 111 63 63 165 165 67 67 67 67 67 67 67 67 111 111 111 111 111 111 111 111 63 63 111 111 111 111 111 111 111 111 111 111 111 111 111 111 111 111 111 111 111 111 61 61 111 111 111 111 111 111 111 111 111 111 63 111 111 111 111 111 111 111 111 111 111 63 63 111 111 111 111 111 111 111 111 111 111 111 111 111 111 111 111 111 111 111 63 63 63 63 63 63 63 63 63 63 63 63 165 165 165 165 63 111 111 111 111 111 111 111 111 111 111 111 111 111 111 111 111 111 111 111 111 111 111 111 63 165 63 111 111 111 111 111 111 111 544 
487 111 111 111 111 111 111 111 111 111 111 111 111 63 63 63 63 67 67 67 67 67 111 111 111 111 111 111 63 63 63 63 63 165 165 63 63 63 111 111 111 111 111 111 111 111 111 111 111 111 111 111 111 111 111 61 61 61 111 111 111 111 111 111 111 111 111 63 63 111 111 111 111 111 111 111 111 111 63 63 111 111 111 168 168 111 111 111 111 63 63 63 63 63 63 63 63 63 63 63 63 63 63 63 63 63 63 63 63 63 63 63 63 63 63 63 111 111 111 111 111 111 111 111 111 111 111 111 111 111 111 111 111 111 111 111 111 111 111 111 63 165 63 111 111 111 111 111 111 544 
487 111 111 111 111 111 111 111 111 111 111 111 111 111 63 63 63 63 67 67 165 165 63 63 63 63 63 63 63 63 63 63 63 63 63 63 63 63 63 63 63 111 111 111 111 111 111 111 111 111 111 111 111 111 111 61 165 61 61 61 61 111 111 111 111 111 111 111 63 111 111 111 111 111 111 111 111 111 111 63 63 63 63 168 168 168 63 63 63 63 63 63 63 63 63 63 63 63 63 63 63 63 63 111 111 111 111 111 111 111 111 111 111 111 111 111 111 111 111 111 111 111 111 111 111 111 111 111 111 111 111 111 111 111 111 111 111 111 111 111 63 165 63 111 111 111 111 111 111 544 
487 111 111 111 111 111 111 111 111 111 111 111 111 111 111 63 63 63 63 63 63 63 63 63 63 63 63 63 63 63 63 63 63 63 63 63 165 165 165 63 63 63 111 111 111 111 111 111 111 111 111 111 111 111 61 61 61 165 61 61 165 61 111 111 111 111 111 111 63 111 111 111 111 111 111 111 111 111 111 111 111 63 63 168 168 168 168 63 63 63 63 63 63 63 63 63 63 63 63 111 111 111 111 111 111 111 111 111 111 111 111 111 111 111 111 111 111 111 111 111 111 111 111 111 111 111 111 111 111 111 111 111 111 111 111 111 111 111 111 111 63 165 63 111 111 111 111 111 111 544 
487 111 111 111 111 111 111 111 111 111 111 111 111 111 111 111 63 111 111 111 111 111 111 111 111 111 111 111 111 111 111 111 111 111 111 63 63 63 63 63 63 63 111 111 111 111 111 111 111 111 111 111 111 61 61 61 61 61 67 67 67 67 111 111 111 111 111 111 63 63 111 111 111 111 111 111 111 111 111 111 111 111 111 111 111 111 111 111 111 111 111 111 111 111 111 111 111 111 111 111 111 111 111 111 111 111 111 111 111 111 111 111 111 111 111 111 111 111 111 111 111 111 111 111 111 111 111 111 111 111 111 111 111 111 111 111 111 111 111 111 111 63 165 63 111 111 111 111 111 544 
487 111 111 111 111 111 111 111 111 111 111 111 111 111 111 111 111 111 111 111 111 111 111 111 111 111 111 111 111 111 111 111 111 111 111 111 63 63 63 63 63 63 63 111 111 111 111 111 111 111 111 111 61 61 61 61 61 67 67 67 61 61 111 111 111 111 111 111 111 63 63 111 111 111 111 111 111 111 111 111 111 111 111 111 111 111 111 111 111 111 111 111 111 111 111 111 111 111 111 111 111 111 111 111 111 111 111 111 111 111 111 111 111 111 111 111 111 111 111 111 111 111 111 111 111 111 111 111 111 111 111 111 111 111 111 111 111 111 111 111 111 63 165 63 111 111 111 111 111 544 
487 111 111 111 111 111 111 111 111 111 111 111 111 111 111 111 111 111 111 111 111 111 111 111 111 111 111 111 111 111 111 111 111 111 111 111 111 111 63 63 63 63 63 63 111 111 111 111 111 111 111 111 61 61 61 67 67 67 67 67 61 61 61 111 111 111 111 111 111 111 63 111 111 111 111 111 111 111 111 111 111 111 111 111 111 111 111 111 111 111 111 111 111 111 111 111 111 111 111 111 111 111 111 111 111 111 111 111 111 111 111 111 111 111 111 111 111 111 111 111 111 111 111 111 111 111 111 111 111 111 111 111 111 111 111 111 111 111 111 111 111 63 165 63 111 111 111 111 111 544 
487 111 111 111 111 111 111 111 111 111 111 111 111 111 111 111 111 111 111 111 111 111 111 111 111 111 111 111 111 111 111 111 111 111 111 111 111 111 111 111 111 111 63 63 111 111 111 111 111 111 111 111 61 165 165 61 61 67 67 61 61 61 111 111 111 111 111 111 111 111 63 111 111 111 111 111 111 111 111 111 111 111 111 111 111 111 111 111 111 111 111 111 111 111 111 111 111 111 111 111 111 111 111 111 111 111 111 111 111 111 111 111 111 111 111 111 111 111 111 111 111 111 111 111 111 111 111 111 111 111 111 111 111 111 111 111 111 111 111 111 111 63 165 165 63 111 111 111 111 544 
487 111 111 111 111 111 111 111 111 111 111 111 111 111 111 111 111 111 111 111 111 111 111 111 111 111 111 111 111 111 111 111 111 111 111 111 111 111 111 111 111 111 111 63 63 111 111 111 111 111 111 111 61 61 61 61 61 61 111 111 111 111 111 111 111 111 111 111 111 111 63 111 111 111 111 111 111 111 111 111 111 111 111 111 111 111 111 111 111 111 111 111 111 111 111 111 111 111 111 111 111 111 111 111 111 111 111 111 111 111 111 111 111 111 111 111 111 111 111 111 111 111 111 111 111 111 111 111 111 111 111 111 111 111 111 111 111 111 111 111 111 63 165 165 63 111 111 111 111 544 
487 111 111 111 111 111 111 111 111 111 111 111 111 111 111 111 111 111 111 111 111 111 111 111 111 111 111 111 111 111 111 111 111 111 111 111 111 111 111 111 111 111 111 111 63 63 111 111 111 111 111 111 111 111 111 111 111 111 111 111 111 111 111 111 111 111 111 111 111 111 168 111 111 111 111 111 111 111 111 111 111 111 111 111 111 111 111 111 111 111 111 111 111 111 111 111 111 111 111 111 111 111 111 111 111 111 111 111 111 111 111 111 111 111 111 111 111 111 111 111 111 111 111 111 111 111 111 111 111 111 111 111 111 111 111 111 111 111 111 63 63 63 165 165 165 63 111 111 111 544 
487 111 111 111 111 111 111 111 111 111 111 111 111 111 111 111 111 111 111 111 111 111 111 111 111 111 111 111 111 111 111 111 111 111 111 111 111 111 111 111 111 111 111 111 111 63 63 111 111 111 111 111 111 111 111 111 111 111 111 111 111 111 111 111 111 111 111 111 111 111 168 111 111 111 111 111 111 111 111 111 111 111 111 111 111 111 111 111 111 111 111 111 111 111 111 111 111 111 111 111 111 111 111 111 111 111 111 111 111 111 111 111 111 111 111 111 111 111 111 111 111 111 111 111 111 111 111 111 111 111 111 111 111 111 111 111 111 111 63 63 165 165 165 165 63 63 111 111 111 544 
487 111 111 111 111 111 111 111 111 111 111 111 111 111 111 111 111 111 111 111 111 111 111 111 111 111 111 111 111 111 111 111 111 111 111 111 111 111 111 111 111 111 111 111 111 111 63 63 111 111 111 111 111 111 111 111 111 111 111 111 111 111 111 111 111 111 111 111 111 111 168 111 111 111 111 111 111 111 111 111 111 111 111 111 111 111 111 111 111 111 111 111 111 111 111 111 111 111 111 111 111 111 111 111 111 111 111 111 111 111 111 111 111 111 111 111 111 111 111 111 111 111 111 111 111 111 111 111 111 111 111 111 111 111 111 111 111 111 63 165 165 165 63 63 63 111 111 111 111 544 
487 111 111 111 111 111 111 111 111 111 111 111 111 111 111 111 111 111 111 63 63 111 111 111 111 111 111 111 111 111 111 111 111 111 111 111 111 111 111 111 111 111 111 111 111 111 111 63 63 63 63 111 111 111 111 111 111 111 111 111 111 111 111 111 111 111 111 111 111 111 168 111 111 111 111 111 111 111 111 111 111 111 111 111 111 111 221 111 111 111 111 111 111 111 111 111 111 111 111 111 111 111 111 111 111 111 111 111 111 111 111 111 111 111 111 111 111 111 111 111 111 111 111 111 111 111 111 111 111 111 111 111 111 111 111 63 63 63 63 63 63 63 111 111 111 111 111 111 111 544 
487 111 111 111 111 111 111 111 111 111 111 111 111 111 111 111 111 111 111 63 165 63 111 63 111 111 111 111 111 111 111 111 111 111 111 111 111 111 111 111 111 111 111 111 111 111 111 111 111 111 63 63 63 63 111 111 111 111 111 111 111 111 111 111 111 111 111 111 111 111 168 111 111 111 111 111 111 111 111 111 111 111 111 111 111 111 111 111 111 111 111 111 111 111 111 111 111 111 111 111 111 111 111 111 111 111 111 111 111 111 111 111 111 111 111 111 111 111 111 111 111 111 111 111 111 111 111 111 111 111 111 111 63 63 63 63 165 165 63 63 111 111 111 111 111 111 111 111 111 544 
487 111 111 111 111 111 111 111 111 111 111 111 111 111 111 111 111 111 111 63 165 63 111 63 63 111 111 111 111 111 111 111 111 111 111 111 111 111 111 111 111 111 111 111 111 111 111 111 111 111 111 63 165 63 111 111 111 111 111 111 111 111 111 111 111 111 111 111 111 111 168 111 111 111 111 111 111 111 111 111 111 111 111 111 111 111 111 111 111 111 111 111 111 111 111 111 111 111 111 111 111 111 111 111 111 111 111 111 111 111 111 111 111 111 111 111 111 111 111 111 111 111 111 111 111 111 111 111 111 111 111 63 63 165 165 165 165 63 63 111 111 111 111 111 111 111 111 111 111 544 
487 111 111 111 111 111 111 111 111 111 111 111 111 111 111 111 111 111 111 111 63 63 111 63 111 111 111 111 111 111 111 111 111 111 111 111 111 111 111 111 111 111 111 111 111 111 111 111 111 111 111 111 63 165 63 111 111 111 111 111 111 111 111 111 111 111 111 111 111 168 168 168 111 111 111 111 111 111 111 111 111 111 111 111 111 111 111 111 111 111 111 111 111 111 111 111 111 111 111 111 111 111 111 111 111 111 111 111 111 111 111 111 111 111 111 111 111 111 111 111 111 111 111 111 111 111 63 63 63 63 63 63 165 63 63 63 63 111 111 111 111 111 111 111 111 111 111 111 111 544 
487 111 111 111 111 111 111 111 111 111 111 111 111 111 111 111 111 111 111 111 63 111 111 63 111 111 111 111 111 111 111 111 111 111 111 111 111 111 111 111 111 111 111 111 111 111 111 111 111 111 111 111 63 165 165 63 111 111 111 111 111 111 111 111 111 111 111 111 111 168 168 168 111 111 111 111 111 111 111 111 111 111 111 111 111 111 111 111 111 111 111 111 111 111 111 111 111 111 111 111 111 111 111 111 111 111 111 111 111 111 111 111 111 111 111 111 111 111 111 111 111 111 63 63 63 63 63 63 63 63 63 63 63 165 63 67 111 111 111 111 111 111 111 111 111 111 111 111 111 544 
487 111 111 111 111 111 111 111 111 111 111 111 111 111 111 111 111 111 111 111 63 63 63 63 111 111 111 111 111 111 111 111 111 111 111 111 111 111 111 111 111 111 111 111 111 111 111 111 111 111 111 111 63 165 165 63 111 111 111 111 111 111 111 111 111 111 111 111 111 168 168 168 111 111 111 111 111 111 111 111 111 111 111 111 111 111 111 111 111 111 111 111 111 111 111 111 111 111 111 111 111 111 111 111 111 111 111 111 111 111 111 111 111 111 111 111 111 111 63 63 63 63 63 63 63 63 165 165 165 165 165 63 63 67 67 67 111 111 111 111 111 111 111 111 111 111 111 111 111 544 
487 111 111 111 111 111 111 111 111 111 111 111 111 111 111 111 111 111 111 111 63 63 63 111 111 111 111 111 111 111 111 111 111 111 111 111 111 111 111 111 111 111 111 111 111 111 111 111 111 111 111 111 63 165 63 63 111 111 111 111 111 111 111 111 111 111 111 111 111 111 111 63 111 111 111 111 111 111 111 111 111 111 111 111 111 111 111 111 111 111 111 111 111 111 111 111 111 111 111 111 111 111 111 111 111 111 111 111 111 111 111 111 63 63 63 63 63 63 111 111 111 111 111 111 67 67 165 57 57 57 63 165 165 67 67 67 67 111 111 111 111 111 111 111 111 111 111 111 111 544 
63 63 63 111 111 111 111 111 111 111 111 111 111 111 111 111 111 111 111 63 63 63 63 111 111 111 111 111 111 111 111 111 111 111 111 111 111 111 111 111 111 111 111 111 111 111 111 111 111 111 111 111 111 63 63 63 111 111 111 111 111 111 111 111 111 111 111 111 111 111 63 111 111 111 111 111 111 111 111 111 111 111 111 111 111 111 111 111 111 111 111 111 111 111 111 111 111 111 111 111 111 111 63 63 63 63 63 63 63 63 63 63 63 111 111 111 111 111 111 111 111 111 111 111 111 57 57 63 63 57 57 165 165 165 67 67 67 67 111 111 111 111 111 111 111 111 111 111 111 544 
63 63 63 63 63 111 111 111 111 111 111 111 111 111 111 111 111 111 63 165 63 63 63 111 111 111 111 111 111 111 111 111 111 111 111 111 111 111 111 111 111 111 111 111 111 111 111 111 111 111 111 111 111 63 63 165 63 111 111 111 111 111 111 111 111 111 111 111 111 111 63 111 111 111 111 111 111 111 111 111 111 111 111 111 111 111 111 111 111 111 111 111 111 111 111 111 111 111 63 63 63 63 63 63 63 63 63 63 111 111 111 111 111 111 111 111 111 111 111 111 111 111 111 111 57 57 165 165 165 57 57 57 57 57 67 67 165 67 111 111 111 111 111 111 111 111 111 111 111 544 
487 111 63 63 63 63 111 111 111 111 111 111 111 111 111 111 111 63 165 67 165 63 111 111 111 111 111 111 111 111 111 111 111 61 111 111 111 111 111 111 111 111 111 111 111 111 111 111 111 111 111 111 111 63 63 165 63 111 111 111 111 111 111 111 111 111 111 111 111 111 63 111 111 111 111 111 111 111 111 111 111 111 111 111 111 111 111 111 111 111 111 111 111 63 63 63 63 63 63 63 63 63 111 111 111 111 111 111 111 111 111 111 111 111 111 111 111 111 111 111 111 111 111 111 111 67 67 165 165 57 165 57 165 165 57 57 67 67 67 111 111 111 111 111 111 111 111 111 111 544 
487 111 111 63 63 63 63 111 111 111 111 111 111 63 111 63 67 165 67 67 165 63 111 111 111 111 111 111 111 111 111 111 61 61 111 111 111 111 111 111 111 111 111 111 111 111 111 111 111 111 111 111 111 63 63 165 63 111 111 111 111 111 111 111 111 111 111 111 111 111 63 111 111 111 111 111 111 111 111 111 111 111 111 111 111 111 111 111 111 63 63 63 63 165 165 165 63 63 111 111 111 63 63 63 111 111 111 111 111 111 111 111 111 111 111 111 111 111 111 111 111 111 111 111 111 111 67 67 165 57 165 57 165 165 165 57 67 67 67 67 111 111 111 111 111 111 111 111 111 544 
487 111 111 111 111 111 63 63 63 63 63 111 111 63 63 67 67 67 67 67 165 63 111 111 111 111 111 111 111 111 111 111 61 61 111 111 111 111 111 111 111 111 111 111 111 111 111 111 111 111 111 111 111 111 63 165 63 111 111 111 111 111 111 111 111 111 111 111 111 63 111 111 111 111 111 111 111 111 111 111 111 111 111 111 111 111 63 63 63 63 63 63 63 63 63 63 111 111 111 111 63 63 63 63 63 111 111 111 111 111 111 111 111 111 111 111 111 111 111 111 111 111 111 111 111 111 111 67 67 57 165 57 165 165 165 165 57 67 165 67 67 111 111 111 111 111 111 111 111 544 
487 111 111 111 111 111 111 111 111 63 63 63 63 63 63 165 67 67 67 63 63 63 111 111 111 111 111 111 111 111 111 111 111 61 61 61 61 61 61 61 61 61 111 111 111 111 111 111 111 111 111 111 111 111 63 165 63 111 111 111 111 111 111 111 111 111 111 111 63 63 111 111 111 111 111 111 111 111 111 111 111 111 111 111 111 63 63 63 63 63 63 111 111 111 111 111 111 111 111 111 63 63 165 63 63 63 111 111 111 111 111 111 111 111 111 111 111 111 111 111 111 111 111 111 111 111 111 111 111 67 57 57 165 57 57 165 57 67 67 67 67 111 111 111 111 111 111 111 111 544 
487 111 111 111 111 111 111 111 111 111 111 63 63 63 63 67 67 67 63 63 63 111 111 111 111 111 111 111 111 111 111 111 111 111 61 165 67 61 61 61 165 67 61 61 111 111 111 111 111 111 111 111 111 111 63 63 63 111 111 111 111 111 111 111 111 111 111 111 63 111 111 111 111 111 111 111 111 111 111 111 111 111 111 111 111 63 165 165 63 111 111 111 111 111 111 111 111 111 111 111 111 111 63 63 63 63 63 111 111 111 111 111 111 111 907 908 111 111 111 111 111 111 111 111 111 111 111 111 111 111 57 165 57 57 57 165 57 57 67 67 67 111 111 111 111 111 111 111 111 544 
487 111 111 111 111 111 111 111 111 111 111 63 165 63 67 67 67 67 67 67 67 111 111 111 111 111 111 111 111 111 111 111 111 111 61 61 67 67 67 67 67 67 165 61 61 111 111 111 111 111 111 111 111 111 111 63 63 111 111 111 111 111 111 111 111 111 111 63 63 111 111 111 111 111 111 111 111 111 111 111 111 111 111 111 111 63 165 63 111 111 111 111 111 111 111 111 111 111 111 111 111 111 111 111 63 63 63 111 111 111 111 111 111 111 961 962 111 111 111 111 111 111 111 111 111 111 111 111 111 111 67 57 165 57 57 57 165 57 67 165 67 111 111 111 111 111 111 111 111 544 
487 111 111 111 111 111 111 111 111 111 111 63 165 63 63 63 165 165 63 165 63 111 111 111 111 111 111 111 111 111 111 111 111 111 111 111 61 61 61 67 67 67 67 61 61 111 111 111 111 111 111 111 111 111 111 63 63 111 111 63 63 111 111 63 111 111 63 63 111 111 111 111 111 111 111 111 111 111 111 111 111 111 111 111 111 63 63 111 111 111 111 111 111 111 111 111 111 111 111 111 111 111 111 111 63 63 63 111 111 111 111 111 111 111 111 111 111 111 111 111 111 111 111 111 111 111 111 111 111 111 111 67 57 57 57 57 57 57 165 165 67 111 111 111 111 111 111 111 111 544 
487 111 111 111 111 111 111 111 111 111 111 111 63 63 165 63 63 165 63 63 165 63 111 111 111 111 111 111 111 111 111 111 111 111 111 111 111 61 61 165 67 67 61 61 111 111 111 111 111 111 111 111 111 111 111 63 63 111 111 111 63 63 63 63 63 63 111 111 111 111 111 111 111 111 111 111 111 111 111 111 111 111 111 111 111 63 63 111 111 111 111 111 111 111 111 111 111 111 111 111 111 111 111 111 111 111 63 63 63 111 111 111 111 111 111 111 111 111 111 111 111 111 111 111 111 111 111 111 111 111 111 111 67 165 57 57 57 57 57 165 67 111 111 111 111 111 111 111 111 544 
487 111 111 111 111 111 111 111 111 111 111 111 111 111 63 165 63 63 63 63 165 63 111 111 111 111 111 111 111 111 111 111 111 111 111 111 111 111 111 61 67 165 61 61 111 111 111 111 111 111 111 111 111 111 111 63 111 111 111 111 111 63 63 111 111 111 111 111 111 111 111 111 111 111 111 111 111 111 111 111 111 111 111 111 111 63 63 111 111 111 111 111 111 111 111 111 111 111 111 111 111 111 111 111 111 111 111 63 165 63 63 111 111 111 111 111 111 111 111 111 63 111 111 111 111 111 111 111 111 111 111 111 111 67 165 57 57 57 57 57 67 111 111 111 111 111 111 111 111 544 
487 111 111 907 908 111 111 111 111 111 111 111 111 111 111 63 63 63 63 63 165 63 111 111 111 111 111 111 111 111 111 111 111 111 111 111 111 111 111 111 61 61 61 61 111 111 111 111 111 111 111 111 111 111 63 63 63 63 63 63 63 63 63 111 111 111 111 111 111 111 111 111 111 111 111 111 111 111 111 111 111 111 111 111 111 63 111 111 111 111 111 111 111 111 111 111 111 111 111 111 111 111 111 111 111 111 111 111 63 63 63 63 111 111 111 111 111 111 111 111 63 63 111 111 111 111 111 111 111 111 111 111 111 67 67 165 57 57 57 57 57 111 111 111 111 111 111 111 111 544 
487 111 111 961 962 111 111 111 111 111 111 111 111 111 111 111 63 63 63 165 63 63 111 111 111 111 111 111 111 111 111 111 111 111 111 111 111 111 111 111 111 111 111 111 111 111 111 111 111 111 111 111 111 111 111 111 63 63 63 63 63 111 111 111 111 111 111 111 111 111 111 111 111 111 111 111 111 111 111 111 111 111 111 111 111 63 111 111 111 111 111 111 111 111 111 111 111 111 111 111 111 111 111 111 111 111 111 111 63 165 63 63 63 111 111 111 111 111 111 111 63 63 111 111 111 111 111 111 111 111 111 111 111 111 67 67 165 57 57 165 57 67 111 111 111 111 111 111 111 544 
487 111 111 111 111 111 111 111 111 111 111 111 111 111 111 111 111 111 63 165 165 63 63 63 63 63 63 111 111 111 111 111 111 111 111 111 111 111 111 111 111 111 111 111 111 111 111 111 111 111 111 111 111 111 111 111 111 111 111 111 111 111 111 111 111 111 111 111 111 111 111 111 111 111 111 111 111 111 111 111 111 111 111 111 111 63 111 111 111 111 111 111 111 111 111 111 111 111 111 111 111 111 111 111 111 111 111 111 63 63 165 63 63 111 111 111 111 111 111 111 111 63 63 111 111 111 111 111 111 111 111 111 111 111 111 67 165 165 57 57 165 67 111 111 111 111 111 111 111 544 
487 111 111 111 111 111 111 111 111 111 111 111 111 111 111 111 111 111 63 63 63 63 63 63 165 165 63 111 111 111 111 111 111 111 111 111 111 111 111 111 111 111 111 111 111 111 111 111 111 111 111 111 111 111 111 111 111 111 111 111 111 111 111 111 111 111 111 111 111 111 111 111 111 111 111 111 111 111 111 111 111 111 111 111 63 63 111 111 111 111 111 111 111 111 111 111 111 111 111 111 111 111 111 111 111 111 111 111 111 63 63 63 63 63 111 111 111 111 111 111 111 63 63 63 111 111 111 111 111 111 111 111 111 111 111 67 67 67 67 165 165 67 111 111 111 111 111 111 111 544 