451,452,452,452,452,452,452,452,452,452,452,452,452,452,452,452,452,452,452,452,452,452,452,452,452,452,452,452,452,452,452,452,452,452,452,452,452,452,452,452,452,452,452,452,452,452,452,452,452,452,452,452,452,452,452,452,452,452,452,452,452,452,452,452,452,452,452,452,452,452,452,452,452,452,452,452,452,452,452,454,
505,111,111,111,111,111,111,111,111,111,111,111,111,111,111,111,111,111,111,111,111,111,111,111,111,111,111,111,111,111,111,111,111,111,111,111,111,111,111,111,111,111,111,111,111,111,111,111,111,111,111,111,111,111,111,111,111,111,111,111,111,111,111,111,111,111,111,111,111,111,111,111,111,111,111,111,111,111,111,508,
505,111,111,111,111,111,111,111,111,111,111,111,111,111,111,111,111,111,111,111,111,111,111,111,111,111,111,111,111,111,111,111,111,111,111,111,111,111,111,111,111,111,111,111,111,111,111,111,111,111,111,111,111,111,111,111,111,111,111,111,111,111,111,111,111,111,111,111,111,111,111,111,111,111,111,111,111,111,111,508,
505,111,111,111,111,111,111,111,111,111,111,111,111,111,111,111,111,111,111,111,111,111,111,111,111,111,111,111,111,111,111,111,111,111,111,111,111,111,111,111,111,111,111,111,111,111,111,111,111,111,111,111,111,111,111,111,111,111,111,111,111,111,111,111,111,111,111,111,111,111,111,111,111,111,111,111,111,111,111,508,
505,111,111,111,111,111,111,111,111,111,111,111,111,111,111,111,111,111,111,111,111,111,111,111,111,111,111,111,111,111,111,111,111,111,111,111,111,111,111,111,111,111,111,111,111,111,111,111,111,452,111,111,111,111,111,111,111,111,111,111,111,111,111,111,111,111,111,111,111,111,111,111,111,111,111,111,111,111,111,508,
505,111,111,111,111,111,111,111,111,111,111,111,111,111,111,111,111,111,111,111,111,111,111,111,111,111,111,111,111,111,111,111,111,111,111,111,111,111,111,111,111,111,111,111,111,111,111,452,452,452,111,111,111,111,111,111,111,111,111,111,111,111,111,111,111,111,111,111,111,111,111,111,111,111,111,111,111,111,111,508,
505,111,111,111,111,111,111,111,111,111,111,111,111,111,111,111,111,111,111,111,111,111,111,111,111,111,111,111,111,111,111,111,111,111,111,111,111,111,111,111,111,111,111,111,452,452,452,452,111,111,111,111,111,111,111,111,111,111,111,111,111,111,452,452,452,111,111,111,111,111,111,111,111,111,111,111,111,111,111,508,
505,111,111,111,111,111,111,111,111,111,111,111,111,111,111,111,111,111,111,111,111,111,111,111,111,111,111,111,111,111,111,111,111,111,111,111,111,111,111,111,111,452,452,452,452,111,111,111,111,111,111,111,111,111,111,111,111,111,452,452,452,452,111,111,111,111,111,111,111,111,111,111,111,111,111,111,111,111,111,508,
505,111,111,111,111,111,111,111,111,111,111,111,111,111,111,111,111,111,111,111,111,111,111,111,111,111,111,111,111,111,111,111,111,111,111,111,111,452,452,452,452,111,111,111,111,111,111,111,111,111,111,452,452,452,452,452,452,452,452,111,111,111,111,111,111,111,111,111,111,111,111,111,111,111,111,111,111,111,111,508,
505,111,111,111,111,111,111,111,111,111,111,111,111,111,111,111,111,111,111,111,111,111,111,111,111,111,111,111,111,111,111,111,111,111,452,452,452,111,111,111,111,111,111,111,111,111,111,111,111,452,452,452,111,111,111,111,111,111,111,111,111,111,111,111,111,111,111,111,111,111,111,111,111,111,111,111,111,111,111,508,
505,111,111,111,111,111,111,111,111,111,111,111,111,111,111,111,111,111,111,111,111,452,452,452,452,452,111,111,111,111,111,111,452,452,111,111,111,111,111,111,111,111,111,111,111,111,111,452,452,452,111,111,111,111,111,111,111,111,111,111,111,111,111,111,111,111,111,111,111,111,111,111,111,111,111,111,111,111,111,508,
505,111,452,452,452,452,452,452,452,452,452,452,452,452,452,452,452,452,452,452,452,452,111,111,111,111,111,111,111,111,452,452,452,111,111,111,111,111,111,111,111,111,111,111,111,111,452,452,111,111,111,111,111,111,111,111,111,111,111,111,111,111,452,111,111,111,111,111,111,111,111,111,111,111,111,111,111,111,111,508,
505,111,111,111,111,111,111,111,111,111,111,111,111,111,111,111,111,111,111,111,111,111,111,111,111,111,111,452,452,452,111,111,111,111,111,111,111,111,111,111,111,111,111,111,111,111,111,111,111,111,111,111,111,111,111,111,111,111,111,111,111,111,452,452,452,111,111,111,111,111,111,111,111,111,111,111,111,111,111,508,
505,111,111,111,111,111,111,111,111,111,111,111,111,111,111,111,111,111,111,111,111,111,111,111,111,452,452,452,111,111,111,111,111,111,111,111,111,111,111,111,111,111,111,111,111,111,111,111,111,111,111,111,111,111,111,111,111,111,111,111,111,111,111,111,452,111,111,111,111,111,111,111,111,111,111,111,111,111,111,508,
505,111,111,111,111,111,111,111,111,111,111,111,111,111,111,111,111,111,111,111,111,111,452,452,452,111,111,111,111,111,111,111,111,111,111,111,111,111,111,111,111,111,111,111,111,111,111,111,111,111,111,111,111,111,111,111,111,111,111,111,111,111,111,111,111,452,111,111,111,111,111,111,111,111,111,111,111,111,111,508,
505,111,111,111,111,111,111,111,111,111,111,111,111,111,111,111,111,111,111,111,111,111,111,111,111,111,111,111,111,111,111,452,452,111,111,111,111,111,111,111,111,111,111,111,111,111,111,111,111,111,111,111,111,111,111,111,452,111,111,111,111,111,111,111,111,452,452,111,111,111,111,111,111,111,111,111,111,111,111,508,
505,111,111,111,111,111,111,111,111,111,111,111,111,111,111,111,111,111,111,111,111,111,111,111,111,111,111,111,111,111,111,452,452,111,111,111,111,111,111,111,111,111,111,111,111,111,111,111,111,111,111,111,111,111,111,111,452,111,111,111,111,111,111,111,111,111,452,111,111,111,111,111,111,111,111,111,111,111,111,508,
505,111,111,111,111,111,111,111,111,111,111,111,111,111,111,111,111,111,111,111,111,111,111,111,111,111,111,111,111,111,111,452,111,111,111,111,111,111,111,111,111,111,111,111,111,111,111,111,111,111,111,111,111,111,111,452,452,452,111,111,111,111,111,111,111,111,111,452,111,111,111,111,111,111,111,111,111,111,111,508,
505,111,111,111,111,111,111,111,111,111,111,111,111,111,111,111,111,111,111,111,111,111,111,111,111,111,111,111,111,111,452,111,111,111,111,111,111,111,111,111,111,111,452,452,111,111,111,111,111,111,111,111,111,111,111,111,111,452,111,111,111,111,111,111,111,111,111,452,452,111,111,111,111,111,111,111,111,111,111,508,
505,111,111,111,111,111,111,111,111,452,452,111,111,111,111,111,111,111,111,111,111,111,111,111,111,111,111,111,452,452,111,111,111,111,111,111,111,111,111,111,111,111,111,452,452,111,111,111,111,111,111,111,111,111,111,111,111,452,111,111,111,111,111,111,111,111,111,111,452,111,111,111,111,111,111,111,111,111,111,508,
505,111,111,111,111,111,111,111,452,452,111,111,111,111,111,111,111,111,111,111,111,111,111,111,111,452,452,452,111,111,111,111,111,111,111,111,111,111,111,111,111,111,111,111,111,452,452,111,111,111,111,111,111,111,111,111,111,452,111,111,111,111,111,111,111,111,111,111,111,452,111,111,111,111,111,111,111,111,111,508,
505,111,111,111,111,111,111,111,452,111,111,111,111,111,111,111,111,111,111,111,111,111,452,452,452,111,111,111,111,111,111,111,111,111,111,111,111,111,111,111,111,111,111,111,111,111,452,111,111,111,111,111,111,111,111,111,111,452,111,111,111,111,111,111,111,111,111,111,111,111,111,111,111,111,111,111,111,111,111,508,
505,111,111,111,111,111,111,111,452,111,111,111,111,111,111,111,111,111,111,452,452,452,111,111,111,111,111,111,111,111,111,111,111,111,111,111,111,111,111,111,111,111,111,111,111,452,452,111,111,111,111,111,111,111,111,111,111,452,111,111,111,111,111,111,111,111,111,111,111,111,111,111,111,111,111,111,111,111,111,508,
505,111,111,111,111,111,111,452,111,111,111,111,111,111,111,111,111,452,452,452,111,111,111,111,111,111,111,111,111,111,111,111,111,111,111,111,111,111,111,111,111,111,111,111,111,452,111,111,111,111,111,111,111,111,111,111,111,452,111,111,111,111,111,111,111,111,111,111,111,111,111,111,111,111,111,111,111,111,111,508,
505,111,111,111,111,111,111,452,111,111,111,111,111,111,452,452,452,111,111,111,111,111,111,111,111,111,111,111,111,111,111,111,111,111,111,111,111,111,111,111,111,111,111,111,111,452,111,111,111,111,111,111,111,111,111,111,452,111,111,111,111,111,111,111,111,111,111,111,111,111,111,111,111,111,111,111,111,111,111,508,
505,111,111,111,111,111,111,452,111,111,111,111,452,452,452,111,111,111,111,111,111,111,111,111,111,111,111,111,111,111,111,111,111,111,111,111,111,111,111,111,111,111,111,111,452,111,111,111,111,111,111,111,111,111,111,452,111,111,111,111,111,111,111,111,111,111,111,111,111,111,111,111,111,111,111,111,111,111,111,508,
505,111,111,111,111,111,111,452,111,111,111,111,111,111,111,111,111,111,111,111,111,111,111,111,111,111,111,111,111,111,111,111,111,111,111,111,111,111,111,111,111,111,111,111,452,111,111,111,111,111,111,111,111,111,452,452,111,111,111,111,111,111,111,111,111,111,111,111,111,111,111,111,111,111,111,111,111,111,111,508,
505,111,111,111,111,111,452,452,111,111,111,111,111,111,111,111,111,111,111,111,111,111,111,111,111,111,111,111,111,111,111,111,111,111,111,111,111,111,111,111,111,111,111,111,452,111,111,111,111,111,111,111,111,111,452,111,111,111,111,111,111,111,111,111,111,111,452,111,111,111,111,111,111,111,111,111,111,111,111,508,
505,111,111,111,111,111,452,452,111,111,111,111,111,111,111,111,111,111,111,111,111,111,111,111,111,111,111,111,111,111,111,111,111,111,111,111,111,111,111,111,111,111,111,111,452,111,111,111,111,111,111,111,111,111,452,111,111,111,111,111,111,111,111,111,111,111,452,452,111,111,111,111,111,111,111,111,111,111,111,508,
505,111,111,111,111,111,111,452,111,111,111,111,111,111,111,111,111,111,111,111,111,111,111,111,111,111,111,111,111,111,111,111,111,111,111,111,111,111,111,111,111,111,111,111,452,111,111,111,111,111,111,111,111,452,111,111,111,111,111,111,111,111,111,111,111,111,111,452,111,111,111,111,111,111,111,111,111,111,111,508,
505,111,111,111,111,111,111,452,111,111,111,111,111,111,111,111,111,111,111,111,111,111,111,111,111,111,111,111,111,111,111,111,111,111,111,111,111,111,111,111,111,111,111,111,111,111,111,111,111,111,111,111,452,111,111,111,111,111,111,111,111,111,111,111,111,111,111,452,111,111,111,111,111,111,111,111,111,111,111,508,
505,111,111,111,111,111,111,452,111,111,111,111,111,111,111,111,111,111,111,111,111,111,111,111,111,111,111,111,111,111,111,111,111,111,111,111,111,111,111,111,111,111,111,111,111,111,111,111,111,111,111,111,452,111,111,111,111,111,111,111,111,111,111,111,111,111,111,452,111,111,111,111,111,111,111,111,111,111,111,508,
505,111,111,111,111,111,111,452,111,111,111,111,111,111,111,111,111,111,111,111,111,111,111,111,111,111,111,111,111,111,452,452,452,452,452,111,111,111,111,111,111,111,111,111,111,111,111,111,111,111,111,452,111,111,111,111,111,111,111,111,111,111,111,111,111,111,111,452,111,111,111,111,111,111,111,111,111,111,111,508,
505,111,111,111,111,111,452,452,111,111,111,111,111,111,111,111,111,111,111,111,111,111,111,111,111,111,111,111,111,111,452,111,111,111,111,111,111,111,111,111,111,111,111,111,111,111,111,111,111,111,111,452,111,111,111,111,111,111,111,111,111,111,111,111,111,111,111,452,111,111,111,111,111,111,111,111,111,111,111,508,
505,111,111,111,111,111,452,111,111,111,111,111,111,111,111,452,452,452,452,111,111,111,111,111,111,111,111,111,111,111,452,111,111,111,111,111,111,111,111,111,111,111,111,111,111,111,111,111,111,111,452,111,111,111,111,111,111,111,111,111,111,111,111,111,111,111,452,111,111,111,111,111,111,111,111,111,111,111,111,508,
505,111,111,111,111,452,452,111,111,111,111,111,111,111,111,111,111,111,111,452,452,452,111,111,111,111,111,111,111,111,452,452,111,111,111,111,111,111,111,111,111,111,111,111,111,111,111,111,111,111,452,111,111,111,111,111,111,111,111,111,111,111,111,111,111,111,452,111,111,111,111,111,111,111,111,111,111,111,111,508,
505,111,111,111,111,452,111,111,111,111,111,111,111,111,111,111,111,111,111,111,111,111,452,452,452,111,111,111,111,111,111,452,111,111,111,111,111,111,111,111,111,111,111,111,111,111,111,111,111,111,452,111,111,111,111,111,111,111,111,111,111,111,111,111,111,111,452,111,111,111,111,111,111,111,111,111,111,111,111,508,
505,111,111,111,111,452,111,111,111,111,111,111,111,111,111,111,111,111,111,111,111,111,111,111,452,452,111,111,111,111,111,452,452,111,111,111,452,111,111,111,111,111,111,111,111,111,111,111,111,452,111,111,111,111,111,111,111,111,111,111,111,111,111,111,111,111,452,111,111,111,111,111,111,111,111,111,111,111,111,508,
505,111,111,111,111,452,111,111,111,111,111,111,111,111,452,111,111,111,111,111,111,111,111,111,111,452,452,111,111,111,111,111,452,111,111,111,452,452,111,111,111,111,111,111,111,111,111,111,111,452,111,111,111,111,111,111,111,111,111,111,111,111,111,111,111,111,452,111,111,111,111,111,111,111,111,111,111,111,111,508,
505,111,111,111,452,452,111,111,111,111,111,111,111,452,452,111,111,111,111,111,111,111,111,111,111,111,452,111,111,111,111,111,452,111,111,111,111,452,111,111,111,111,111,111,111,111,111,111,111,452,452,111,111,111,111,111,111,111,111,111,111,111,111,111,111,452,111,111,111,111,111,111,111,111,111,111,111,111,111,508,
505,111,111,111,452,111,111,111,111,111,111,111,452,111,111,111,111,111,111,111,111,111,111,111,111,452,111,111,111,111,111,111,452,111,111,111,111,452,111,111,111,111,111,111,111,111,111,111,111,111,452,111,111,111,111,111,111,111,111,111,111,111,111,111,111,452,111,111,111,111,111,111,111,111,111,111,111,111,111,508,
505,111,111,452,452,111,111,111,111,111,111,452,452,111,111,111,111,111,111,111,111,111,111,111,111,452,111,111,111,111,111,111,452,111,111,111,111,452,111,111,111,111,111,111,111,111,111,111,111,111,111,452,111,111,111,111,111,111,111,111,111,111,111,111,111,452,111,111,111,111,111,111,111,111,111,111,111,111,111,508,
505,111,111,452,111,111,111,111,111,111,111,452,111,111,111,111,111,111,111,111,111,111,111,111,452,452,111,111,111,111,111,111,452,111,111,111,111,452,111,111,111,111,111,111,111,111,452,111,111,111,111,452,111,111,111,111,111,111,111,111,111,111,111,111,111,452,111,111,111,111,111,111,111,111,111,111,111,111,111,508,
505,111,111,111,111,111,111,111,111,111,111,452,111,111,111,111,111,111,111,111,111,111,111,111,452,111,111,111,111,111,111,111,452,111,111,111,111,452,111,111,111,111,111,111,111,111,452,111,111,111,111,452,111,111,111,111,111,111,111,111,111,111,111,111,111,452,111,111,111,111,111,111,111,111,111,111,111,111,111,508,
505,111,111,111,111,111,111,111,111,111,452,111,111,111,111,111,111,111,111,111,111,111,452,452,111,111,111,111,111,111,111,111,452,111,111,111,111,452,111,111,111,111,111,111,111,111,452,111,111,111,452,111,111,111,111,111,111,111,111,111,111,111,111,111,111,452,111,111,111,111,111,111,111,111,111,111,111,111,111,508,
505,111,111,111,111,111,111,111,111,111,452,111,111,111,111,111,111,111,111,111,111,452,452,111,111,111,111,111,111,111,111,111,452,111,111,111,111,452,111,111,111,111,111,111,111,111,452,111,111,452,111,111,111,111,111,111,111,111,111,111,111,111,111,111,111,452,111,111,111,111,111,111,111,111,111,111,111,111,111,508,
505,111,111,111,111,111,111,111,111,452,452,111,111,111,111,111,111,111,111,452,452,452,111,111,111,111,111,111,111,111,111,111,452,111,111,111,111,452,111,111,111,111,111,111,111,111,111,452,452,111,111,111,111,111,111,111,111,111,111,111,111,111,111,111,452,111,111,111,111,111,111,111,111,111,111,111,111,111,111,508,
505,111,111,111,111,111,111,111,111,452,111,111,111,111,111,111,111,111,111,452,111,111,111,111,111,111,111,111,111,111,111,111,452,111,111,111,111,452,111,111,111,111,111,111,111,111,111,111,111,111,111,111,111,111,111,111,111,111,111,111,111,111,111,111,452,111,111,111,111,111,111,111,111,111,111,111,111,111,111,508,
505,111,111,111,111,111,111,111,111,452,111,111,111,111,111,111,111,111,111,452,452,111,111,111,111,111,111,111,111,111,111,452,111,111,111,111,111,452,111,111,111,111,111,111,111,111,111,111,111,111,111,111,111,111,111,111,111,111,111,111,111,111,111,452,111,111,111,111,111,111,111,111,111,111,111,111,111,111,111,508,
505,111,111,111,111,111,111,111,452,111,111,111,111,111,111,111,111,111,111,111,452,452,111,111,111,111,111,111,111,111,111,452,111,111,111,111,111,452,111,111,111,111,111,111,111,111,111,111,111,111,111,111,111,111,111,111,111,111,111,111,111,111,452,452,111,111,111,111,111,111,111,111,111,111,111,111,111,111,111,508,
505,111,111,111,111,111,111,111,111,111,111,111,111,111,452,111,111,111,111,111,452,452,111,111,111,111,111,111,111,111,452,452,111,111,111,111,111,111,452,111,111,111,111,111,111,111,111,111,111,111,111,111,111,111,111,111,111,111,111,111,111,111,111,111,111,111,111,111,111,111,111,111,111,111,111,111,111,111,111,508,
505,111,111,111,111,111,111,111,111,111,111,111,111,111,111,452,452,452,452,452,452,111,111,111,111,111,111,111,111,111,452,111,111,111,111,111,111,111,452,452,111,111,111,111,111,111,111,111,111,111,111,111,111,111,111,111,111,111,111,111,111,111,111,111,111,111,111,111,111,111,111,111,111,111,111,111,111,111,111,508,
505,111,111,111,111,111,111,111,111,111,111,111,111,111,111,111,111,111,111,111,111,111,111,111,111,111,111,111,452,452,111,111,111,111,111,111,111,111,111,452,452,452,111,111,111,111,111,111,111,111,111,111,111,111,111,111,111,111,111,111,111,111,111,111,111,111,111,111,111,111,111,111,111,111,111,111,111,111,111,508,
505,111,111,111,111,111,111,111,111,111,111,111,111,111,111,111,111,111,111,111,111,111,111,111,111,111,111,111,111,111,111,111,111,111,111,111,111,111,111,111,111,452,452,452,111,111,111,111,111,111,111,111,111,111,111,111,111,111,111,111,111,111,111,111,111,111,111,111,111,111,111,111,111,111,111,111,111,111,111,508,
505,111,111,111,111,111,111,111,111,111,111,111,111,111,111,111,111,111,111,111,111,111,111,111,111,111,111,111,111,111,111,111,111,111,111,111,111,111,111,111,111,111,111,452,452,452,452,111,111,111,111,111,111,111,111,111,111,111,111,111,111,111,111,111,111,111,111,111,111,111,111,111,111,111,111,111,111,111,111,508,
505,111,111,111,111,111,111,111,111,111,111,111,111,111,111,111,111,111,111,111,111,111,111,111,111,111,111,111,111,111,111,111,111,111,111,111,111,111,111,111,111,111,111,111,111,111,452,452,111,111,111,111,111,111,111,111,111,111,111,111,111,111,111,111,111,111,111,111,111,111,111,111,111,111,111,111,111,111,111,508,
505,111,111,111,111,111,111,111,111,111,111,111,111,111,111,111,111,111,111,111,111,111,111,111,111,111,111,111,111,111,111,111,111,111,111,111,111,111,111,111,111,111,111,111,111,111,111,111,452,452,452,111,111,111,452,452,111,111,111,111,111,111,111,111,111,111,111,111,111,111,111,111,111,111,111,111,111,111,111,508,
505,111,111,111,111,111,111,111,111,111,111,111,111,111,111,111,111,111,111,111,111,111,111,111,111,111,111,111,111,111,111,111,111,111,111,111,111,111,111,111,111,111,111,111,111,111,111,111,111,111,111,452,452,452,111,111,111,111,111,111,111,111,111,111,111,111,111,111,111,111,111,111,111,111,111,111,111,111,111,508,
505,111,111,111,111,111,111,111,111,111,111,111,111,111,111,111,111,111,111,111,111,111,111,111,111,111,111,111,111,111,111,111,111,111,111,111,111,111,111,111,111,111,111,111,111,111,111,111,111,111,111,111,111,111,111,111,111,111,111,111,111,111,111,111,111,111,111,111,111,111,111,111,111,111,111,111,111,111,111,508,
613,614,614,614,614,614,614,614,614,614,614,614,614,614,614,614,614,614,614,614,614,614,614,614,614,614,614,614,614,614,614,614,614,614,614,614,614,614,614,614,614,614,614,614,614,614,614,614,614,614,614,614,614,614,614,614,614,614,614,614,614,614,614,614,614,614,614,614,614,614,614,614,614,614,614,614,614,614,614,616